1000000000110000011101111111
111101111111110111N00000010001
11110111111111011100000010001
   