C 255,255,255
NO ./textur
SO ./textur
WE ./textur
EA ./textur

111111
1N 001
100001
100001
111111